111111111111111111111111111111
100000000000000000000000000001
100000000000000000000000000001
100000000000000000000000000001
100000000000000000000104020001
100000250100000000001111111111
111111111101111100000000000001
100000000000000111000000000001
100000000000000000000000000001
100000000000000000000000000001
100000000000001000000020010001
100000000000001111111111110001
100000000000000000000000000001
100000000200000000000020000001
111111111111111111111111111111