111111111111111111111111111111
100000000000000000000000000001
100000000000000000000000000001
100000000000000000000000000001
100000000000400000000000000001
100000500001111000000000000001
100111110000000000000000000001
100000000000000001020310000001
100000000000000001111110000001
100000000102010000000000000001
100000000111110000100020100001
100000000000000000111111100001
100000000000000000000000000001
100000000000000000000000000001
111111111111111111111111111111